"","id","label","timeset","indegree","outdegree","degree","weighted.indegree","weighted.outdegree","weighted.degree","eccentricity","closnesscentrality","harmonicclosnesscentrality","betweenesscentrality","modularity_class","componentnumber","strongcompnum"
"2","SenSanders","SenSanders",NA,5525,0,5525,6507,0,6507,0,0,0,0,0,0,0
"8","fightfor15","fightfor15",NA,3436,166,3602,5364,393,5757,12,0.325619834710744,0.530087129452611,5199445.60672872,0,0,324
"149","chifightfor15","chifightfor15",NA,2318,27,2345,3286,54,3340,13,0.261388766032729,0.363621854738606,1098586.27505671,0,0,324
"15","EconomicPolicy","EconomicPolicy",NA,2291,0,2291,2379,0,2379,0,0,0,0,0,0,36
"342","RevDrBarber","RevDrBarber",NA,1169,0,1169,1171,0,1171,0,0,0,0,0,0,65
"71","RaiseUpfor15","RaiseUpfor15",NA,1144,21,1165,1699,31,1730,13,0.257965953731995,0.35217233415203,466094.148231456,0,0,324
"52","Show_Me15","Show_Me15",NA,1117,23,1140,2012,48,2060,13,0.260927152317881,0.359137929188691,571843.607501322,0,0,324
"906","DerrickQLewis","DerrickQLewis",NA,1115,0,1115,1219,0,1219,0,0,0,0,0,0,73
"13","Kaimandante","Kaimandante",NA,1042,0,1042,1051,0,1051,0,0,0,0,0,0,334
"69","Fightfor15LA","Fightfor15LA",NA,985,29,1014,1402,81,1483,13,0.263721552878179,0.366808543965905,506926.439430444,0,0,324
"1089","TheMarkRomano","TheMarkRomano",NA,850,0,850,950,0,950,0,0,0,0,17,0,93
"1148","scrowder","scrowder",NA,847,0,847,923,0,923,0,0,0,0,17,0,108
"539","SenWarren","SenWarren",NA,698,0,698,699,0,699,0,0,0,0,0,0,24
"265","MarkRuffalo","MarkRuffalo",NA,622,0,622,622,0,622,0,0,0,0,0,0,16
"165","UR_Ninja","UR_Ninja",NA,598,0,598,686,0,686,0,0,0,0,0,0,89
"742","larryelder","larryelder",NA,595,0,595,618,0,618,0,0,0,0,17,0,453
"157","FightFor15FL","FightFor15FL",NA,558,22,580,894,67,961,13,0.255844155844156,0.350883155197877,247196.907973689,0,0,324
"316","ChrisJZullo","ChrisJZullo",NA,545,1,546,651,2,653,0,0,0,0,0,0,32
"488","RoseAnnDeMoro","RoseAnnDeMoro",NA,442,0,442,486,0,486,0,0,0,0,0,0,6
"59","Marc_Perrone","Marc_Perrone",NA,411,4,415,438,4,442,14,0.214674900108972,0.271635574427452,202527.681808019,0,0,324
"1210","fightfor15mass","fightfor15mass",NA,358,27,385,445,57,502,13,0.266937669376694,0.374732965849718,311673.909027818,0,0,324
"451","LawlessPirate","LawlessPirate",NA,356,1,357,358,1,359,0,0,0,0,17,0,105
"3483","LibsNoFun","LibsNoFun",NA,326,5,331,358,5,363,1,1,1,50831,17,0,103
"430","32BJSEIU","32BJSEIU",NA,325,30,355,472,42,514,13,0.266456266907124,0.374507359532741,406185.990041913,0,0,324
"665","FastFoodForward","FastFoodForward",NA,305,27,332,402,69,471,13,0.262084257206208,0.36407306737256,183471.292407038,0,0,324
"61","ATLRaiseUp","ATLRaiseUp",NA,304,3,307,422,10,432,13,0.246661101836394,0.322795168734255,81900.5700287011,0,0,324
"118","fightfor15texas","fightfor15texas",NA,303,10,313,428,37,465,13,0.254521963824289,0.339651183559814,71570.5762907343,0,0,324
"2011","DerenicByrd","DerenicByrd",NA,295,4,299,297,4,301,14,0.202605416523826,0.245791565080905,123940.431113433,0,0,324
"412","1alyssakang","1alyssakang",NA,286,2,288,294,2,296,13,0.245942571785268,0.320398101616376,71872.3210326826,0,0,324
"87","NorCalFF15","NorCalFF15",NA,285,26,311,370,70,440,13,0.261736049601417,0.363057838946164,131796.73719374,0,0,324
"824","Detroit_15","Detroit_15",NA,275,6,281,375,12,387,13,0.248842105263158,0.328914740082253,65331.7951465975,0,0,324
"1162","michellemalkin","michellemalkin",NA,252,0,252,252,0,252,0,0,0,0,17,0,150
"1577","AFLCIO","AFLCIO",NA,252,14,266,267,22,289,13,0.260008798944127,0.35056488914357,130735.672595851,0,0,324
"2039","ajplus","ajplus",NA,252,0,252,252,0,252,0,0,0,0,0,0,578
"3075","TheNewDeal","TheNewDeal",NA,252,0,252,279,0,279,0,0,0,0,0,0,21
"21","jwjnational","jwjnational",NA,247,9,256,286,11,297,13,0.254412397761515,0.338551352764551,92943.3206451203,0,0,324
"1222","GoodAirports","GoodAirports",NA,247,47,294,403,94,497,13,0.271100917431193,0.393683896475775,394786.196096819,0,0,324
"3789","GatorsEite23","GatorsEite23",NA,245,5,250,277,6,283,14,0.205422314911366,0.254372662494489,93600.1131218989,0,0,324
"125","People4Bernie","People4Bernie",NA,237,75,312,271,121,392,12,0.29728370221328,0.431356164985608,540129.502613037,0,0,324
"1576","DemSocialists","DemSocialists",NA,226,12,238,271,19,290,12,0.268027210884354,0.348312896916959,86108.7708070183,0,0,324
"172","FF15ChildCare","FF15ChildCare",NA,220,15,235,318,22,340,13,0.26012323943662,0.353215763368048,99915.4500613754,0,0,324
"1633","democracynow","democracynow",NA,220,0,220,237,0,237,0,0,0,0,0,0,5
"39","standup_kc","standup_kc",NA,215,10,225,259,16,275,13,0.253213367609255,0.337536124338155,67309.8497533328,0,0,324
"3422","MoveOn","MoveOn",NA,213,1,214,266,1,267,14,0.207150368033649,0.252668529064467,76918.8867232714,0,0,324
"10406","AriseChicago","AriseChicago",NA,202,1,203,214,1,215,14,0.207295685724307,0.253756273807034,27613.0025704693,0,0,324
"1213","FightFor15PA","FightFor15PA",NA,189,16,205,273,26,299,13,0.26081200353045,0.355133417062352,131074.440619806,0,0,324
"1907","TheNewThinker","TheNewThinker",NA,174,1,175,212,1,213,13,0.245840266222962,0.319552077927713,64775.323439094,0,0,324
"1742","pragmactivist","pragmactivist",NA,173,22,195,192,28,220,12,0.280760095011876,0.372501117044265,82431.261392937,0,0,324
"4997","NicholsUprising","NicholsUprising",NA,166,0,166,166,0,166,0,0,0,0,0,0,30
"2155","RaiseUpMA","RaiseUpMA",NA,162,16,178,257,30,287,13,0.259324265028521,0.353018357840693,162665.275766904,0,0,324
"1214","Latinos4Bernie","Latinos4Bernie",NA,160,2,162,160,2,162,15,0.179253867151956,0.213512422903286,25023.2732795063,0,0,324
"765","AFSCME","AFSCME",NA,158,5,163,196,5,201,13,0.250529885544722,0.327299237705329,81155.6524728686,0,0,324
"1034","RobinHoodTax","RobinHoodTax",NA,153,6,159,184,8,192,13,0.250848896434635,0.330683332459983,45515.3846229883,0,0,324
"2495","NCFaculty","NCFaculty",NA,149,0,149,157,0,157,0,0,0,0,0,0,53
"3272","JessLivMo","JessLivMo",NA,146,16,162,151,16,167,13,0.255512321660182,0.345432345432346,108691.185316761,0,0,324
"97","syashingo","syashingo",NA,143,0,143,191,0,191,0,0,0,0,91,0,228
"496","BernieCrats1","BernieCrats1",NA,143,0,143,215,0,215,0,0,0,0,0,0,34
"4155","figue32bj","figue32bj",NA,143,23,166,162,28,190,13,0.259894459102902,0.361317447358057,131663.180531119,0,0,324
"66","zachhaller","zachhaller",NA,142,5,147,155,6,161,14,0.208907741251326,0.260129652261631,42693.6437257724,0,0,324
"835","MisterMetokur","MisterMetokur",NA,141,0,141,141,0,141,0,0,0,0,17,0,894
"371","OurRevolution2","OurRevolution2",NA,136,2,138,191,2,193,14,0.207732864674868,0.255532923553227,36510.0606873811,0,0,324
"3763","OccupyWallStNYC","OccupyWallStNYC",NA,131,13,144,150,16,166,13,0.256621797655232,0.346447573858742,69649.5176163005,0,0,324
"8503","ChrisMurphyCT","ChrisMurphyCT",NA,131,0,131,131,0,131,0,0,0,0,0,0,70
"1208","BenSpielberg","BenSpielberg",NA,127,5,132,127,5,132,13,0.247280334728033,0.325276838221001,30002.1947866564,0,0,324
"1922","Tim_Canova","Tim_Canova",NA,126,2,128,126,2,128,14,0.207210360518026,0.252664021414021,28911.8266157276,0,0,398
"6873","LUCHA_AZ","LUCHA_AZ",NA,122,9,131,137,9,146,11,0.287731256085686,0.357445069500908,1483598.56547589,0,0,324
"6798","masseydaniel","masseydaniel",NA,120,2,122,130,2,132,14,0.204215618521078,0.247890509565636,48320.7085894316,0,0,324
"9705","Complex","Complex",NA,116,0,116,116,0,116,0,0,0,0,0,0,1648
"4435","SenSherrodBrown","SenSherrodBrown",NA,115,0,115,115,0,115,0,0,0,0,0,0,68
"2162","ryanstopera","ryanstopera",NA,113,1,114,113,1,114,13,0.245840266222962,0.319552077927713,53610.9101114498,0,0,324
"427","ReelectBernie","ReelectBernie",NA,112,0,112,164,0,164,0,0,0,0,0,0,363
"4117","caroljsroth","caroljsroth",NA,112,0,112,114,0,114,0,0,0,0,17,0,94
"4963","RT_America","RT_America",NA,111,0,111,118,0,118,0,0,0,0,0,0,1116
"1176","SEIU","SEIU",NA,109,36,145,124,65,189,13,0.26986301369863,0.384405836690101,54829.296086612,0,0,324
"2265","itsRamel","itsRamel",NA,109,0,109,109,0,109,0,0,0,0,0,0,1514
"234","CaliforniaLabor","CaliforniaLabor",NA,108,4,112,123,5,128,14,0.2097232079489,0.259879873839264,35134.4393519174,0,0,324
"3449","JCL_VT","JCL_VT",NA,107,0,107,112,0,112,0,0,0,0,0,0,52
"7814","UAW","UAW",NA,104,0,104,112,0,112,0,0,0,0,0,0,56
"3170","MattWalshBlog","MattWalshBlog",NA,102,0,102,102,0,102,0,0,0,0,17,0,1159
"3240","JacquesLoveall","JacquesLoveall",NA,102,0,102,103,0,103,0,0,0,0,0,0,425
"590","KamalaHarris","KamalaHarris",NA,97,0,97,98,0,98,0,0,0,0,0,0,338
"3671","ScottPresler","ScottPresler",NA,94,0,94,94,0,94,0,0,0,0,17,0,137
"3453","LeahRBoss","LeahRBoss",NA,86,2,88,86,2,88,1,1,1,12458.5,17,0,134
"30","PascoRevolution","PascoRevolution",NA,84,1,85,100,1,101,1,1,1,12213,0,0,222
"358","aequitas1500","aequitas1500",NA,83,9,92,95,15,110,13,0.25105663567202,0.332099634372362,46801.6126678877,91,0,700
"3523","JimmyPrinceton","JimmyPrinceton",NA,81,0,81,81,0,81,0,0,0,0,17,0,190
"5727","greenhousenyt","greenhousenyt",NA,81,0,81,85,0,85,0,0,0,0,0,0,40
"2057","acbowen","acbowen",NA,80,0,80,94,0,94,0,0,0,0,0,0,200
"5963","PghUNITED","PghUNITED",NA,80,2,82,102,2,104,14,0.208025343189018,0.254308203546782,32697.1863965435,0,0,324
"17636","CommsUnited","CommsUnited",NA,80,5,85,112,10,122,14,0.208245243128964,0.259199026204102,41027.8533692247,0,0,324
"5860","KCTomDempsey","KCTomDempsey",NA,79,0,79,106,0,106,0,0,0,0,0,0,275
"6720","PLANevada","PLANevada",NA,78,8,86,90,10,100,13,0.246970330129545,0.32646127138513,70293.6136891124,0,0,324
"2413","seiufl","seiufl",NA,77,20,97,95,32,127,13,0.257853403141361,0.35440825390064,66820.3035042773,0,0,324
"6738","NBCNews","NBCNews",NA,76,0,76,79,0,79,0,0,0,0,0,0,313
"5388","emrutherford90","emrutherford90",NA,74,0,74,74,0,74,0,0,0,0,17,0,92
"113","SenWarren2020","SenWarren2020",NA,73,3,76,93,3,96,15,0.175879396984925,0.208937789568042,14037.0455657339,0,0,485
"339","bradlander","bradlander",NA,73,4,77,86,5,91,14,0.210470085470085,0.261805584902031,53657.7210458885,0,0,324
"4373","PCsBeard","PCsBeard",NA,73,1,74,75,1,76,1,1,1,73,17,0,1666
"6696","ms_erika74","ms_erika74",NA,73,1,74,73,1,74,0,0,0,0,17,0,90
"723","squidartdotcom","squidartdotcom",NA,72,5,77,87,6,93,13,0.250423728813559,0.329555300875098,18679.2209183537,0,0,324
