"","id","label","timeset","indegree","outdegree","degree","weighted.indegree","weighted.outdegree","weighted.degree","eccentricity","closnesscentrality","harmonicclosnesscentrality","betweenesscentrality","modularity_class","componentnumber","strongcompnum"
"10662","SaVonniYestanti","SaVonniYestanti",NA,19,383,402,23,516,539,12,0.417682926829268,0.632514591769023,21852.1257835268,0,0,1737
"8","fightfor15","fightfor15",NA,3436,166,3602,5364,393,5757,12,0.325619834710744,0.530087129452611,5199445.60672872,0,0,324
"3371","DOJSuedFerguson","DOJSuedFerguson",NA,0,126,126,0,172,172,13,0.306289881494986,0.47884501411287,0,0,0,4101
"89","rjber15","rjber15",NA,0,124,124,0,465,465,12,0.31165452653486,0.483330261836105,0,0,0,432
"2987","lord_nikon9","lord_nikon9",NA,2,115,117,2,153,155,13,0.342867357883447,0.470867181711809,3831.47216067558,0,0,1737
"378","sc1199","sc1199",NA,0,106,106,0,202,202,12,0.305696846388606,0.463474476161664,0,0,0,795
"78","JustinTyme5","JustinTyme5",NA,0,84,84,0,152,152,12,0.300355149670218,0.442170315607816,0,0,0,404
"9","LongfellowJean","LongfellowJean",NA,0,80,80,0,244,244,13,0.277413308341143,0.425282403407404,0,0,0,331
"98","leoluminary","leoluminary",NA,0,80,80,0,125,125,12,0.299605133267522,0.437091971729534,0,0,0,451
"125","People4Bernie","People4Bernie",NA,237,75,312,271,121,392,12,0.29728370221328,0.431356164985608,540129.502613037,0,0,324
"86","MarieJenkins10","MarieJenkins10",NA,0,68,68,0,172,172,12,0.291626095423564,0.418472165008059,0,0,0,424
"229","conlimonisal","conlimonisal",NA,0,53,53,0,136,136,13,0.273891175125743,0.401308596801085,0,0,0,621
"25343","jallen1299","jallen1299",NA,0,51,51,0,66,66,12,0.333448993754337,0.422752161123648,0,0,0,25310
"662","disruptivedigit","disruptivedigit",NA,0,47,47,0,91,91,13,0.275395033860045,0.399190281485364,0,0,0,1118
"1222","GoodAirports","GoodAirports",NA,247,47,294,403,94,497,13,0.271100917431193,0.393683896475775,394786.196096819,0,0,324
"758","pgrandee10","pgrandee10",NA,0,46,46,0,80,80,12,0.284548944337812,0.39538756634035,0,0,0,1216
"15810","OzarkFinesseGuy","OzarkFinesseGuy",NA,1,46,47,1,51,52,10,0.261968085106383,0.327828807778046,915451.5,17,0,324
"2078","LaborDemocracy_","LaborDemocracy_",NA,7,44,51,9,97,106,13,0.270480549199085,0.391371431726762,26386.3128937786,0,0,324
"14531","OldSaukRiver","OldSaukRiver",NA,0,44,44,0,68,68,12,0.282567947516401,0.388360685748746,0,0,0,14868
"15353","graygoods","graygoods",NA,0,44,44,0,53,53,13,0.273224043715847,0.392806415806417,0,0,0,15629
"105","grannysidney","grannysidney",NA,0,43,43,0,69,69,13,0.27337807606264,0.391790261021031,0,0,0,474
"332","burnodo","burnodo",NA,0,43,43,0,103,103,13,0.273853211009174,0.395813259883612,0,0,0,740
"664","tizutyanchiz","tizutyanchiz",NA,0,43,43,0,157,157,13,0.275046382189239,0.396796823188055,0,0,0,1120
"4022","_green_mountain","_green_mountain",NA,0,43,43,0,78,78,12,0.289115646258503,0.40044508712576,0,0,0,4708
"7112","joelfrominwood","joelfrominwood",NA,1,42,43,1,75,76,13,0.272933696639419,0.392596532696367,601,0,0,7730
"2893","Konducta4LFE","Konducta4LFE",NA,0,41,41,0,64,64,12,0.28203906622201,0.388144414706915,0,0,0,3609
"139","montyiavelli","montyiavelli",NA,0,40,40,0,81,81,13,0.264167782240071,0.376999745749746,0,0,0,523
"4756","SharonP83012021","SharonP83012021",NA,0,40,40,0,61,61,13,0.272357723577236,0.388502790741597,0,0,0,5438
"470","JudyJones1990","JudyJones1990",NA,0,39,39,0,53,53,12,0.290416263310745,0.397941378066379,0,0,0,917
"8275","Jodi7768","Jodi7768",NA,0,38,38,0,45,45,13,0.268744354110208,0.383614312858011,0,0,0,8836
"12571","JaynePenelope","JaynePenelope",NA,23,37,60,26,44,70,3,0.708860759493671,0.8125,1576,17,0,902
"1176","SEIU","SEIU",NA,109,36,145,124,65,189,13,0.26986301369863,0.384405836690101,54829.296086612,0,0,324
"14101","cjgrimes","cjgrimes",NA,0,36,36,0,40,40,13,0.263525305410122,0.371827565370612,0,0,0,14463
"4606","SUNYLF","SUNYLF",NA,1,34,35,1,40,41,13,0.2617823479006,0.364730795663693,179.227340595661,0,0,5286
"8375","PhillyCluw","PhillyCluw",NA,11,34,45,20,68,88,12,0.282588011417697,0.383975578293761,2384.57127551209,0,0,470
"13142","sickjew","sickjew",NA,1,34,35,1,78,79,14,0.237146273415703,0.341550149197208,119.252740534319,0,0,13548
"771","gskiii_15217","gskiii_15217",NA,0,33,33,0,45,45,13,0.273018781493358,0.38593487049863,0,0,0,1230
"1284","gramsci1937","gramsci1937",NA,0,33,33,0,48,48,13,0.270066518847007,0.378572276109223,0,0,0,2018
"1507","LocalProgress","LocalProgress",NA,0,32,32,0,46,46,12,0.280585734529995,0.379261773579956,0,0,0,2245
"1595","RebColdRiver","RebColdRiver",NA,0,32,32,0,45,45,13,0.266696349065004,0.374305257902921,0,0,0,2336
"4711","elisha1022","elisha1022",NA,0,32,32,0,38,38,13,0.269698334083746,0.381386504424902,0,0,0,5389
"2463","rabbeni_kim","rabbeni_kim",NA,1,31,32,1,39,40,13,0.265108072342303,0.371576011343067,601,0,0,3184
"430","32BJSEIU","32BJSEIU",NA,325,30,355,472,42,514,13,0.266456266907124,0.374507359532741,406185.990041913,0,0,324
"1329","Ah_occ_o","Ah_occ_o",NA,1,30,31,1,50,51,13,0.266190263510496,0.373658584145162,16.4685850097615,0,0,916
"1556","CPDAction","CPDAction",NA,4,30,34,4,31,35,10,0.289422135161606,0.358013724384283,1450446.35849334,0,0,324
"1627","MariaVukmir","MariaVukmir",NA,0,30,30,0,51,51,13,0.265966754155731,0.372506331387911,0,0,0,2371
"3675","LindaKe18525","LindaKe18525",NA,0,30,30,0,48,48,12,0.280718336483932,0.377466038450888,0,0,0,4380
"4615","allman1100","allman1100",NA,1,30,31,3,62,65,13,0.251873438800999,0.34457385589617,0,0,0,5295
"15525","jeffl76","jeffl76",NA,5,30,35,6,31,37,13,0.262722923010004,0.364818735348537,1389.15478441424,0,0,6882
"20702","nezua","nezua",NA,0,30,30,0,35,35,12,0.280669144981413,0.377204459447838,0,0,0,20776
"21527","girlact75","girlact75",NA,0,30,30,0,34,34,13,0.318032786885246,0.406781746317827,0,0,0,21582
"69","Fightfor15LA","Fightfor15LA",NA,985,29,1014,1402,81,1483,13,0.263721552878179,0.366808543965905,506926.439430444,0,0,324
"1351","RevMelanieNOLA","RevMelanieNOLA",NA,3,29,32,3,55,58,12,0.278403755868545,0.373830511815336,1303.01068931069,0,0,2089
"1733","VirginiaInCal","VirginiaInCal",NA,0,29,29,0,36,36,12,0.284186046511628,0.37978422286933,0,0,0,2474
"11371","cluwlaura","cluwlaura",NA,0,29,29,0,63,63,12,0.278819119025305,0.373246207573939,0,0,0,11830
"14452","bikeberg","bikeberg",NA,0,29,29,0,57,57,12,0.280568720379147,0.37800927957178,0,0,0,14791
"21718","BillyScoots123","BillyScoots123",NA,0,29,29,0,30,30,10,0.185251798561151,0.233370575846304,0,17,0,21777
"336","4evrstardancer","4evrstardancer",NA,0,28,28,0,47,47,13,0.260201842913559,0.36035312822834,0,0,0,745
"2767","MarcMacaire","MarcMacaire",NA,6,28,34,6,47,53,13,0.267841011743451,0.375829987887324,871.633809841116,0,0,1464
"5605","sparkyNadine","sparkyNadine",NA,0,28,28,0,33,33,13,0.264915405164737,0.370252968320196,0,0,0,6270
"5904","NBisno","NBisno",NA,35,28,63,42,55,97,13,0.268148820326679,0.378286265342104,50147.0634518791,0,0,324
"6292","K810Mt","K810Mt",NA,0,28,28,0,38,38,12,0.27689429373246,0.373906962969464,0,0,0,6938
"115","pausetheprocess","pausetheprocess",NA,0,27,27,0,44,44,13,0.264285714285714,0.368891637641638,0,0,0,488
"126","lahautj","lahautj",NA,0,27,27,0,37,37,13,0.267927848658161,0.3731535568974,0,0,0,503
"130","LouisianaBernie","LouisianaBernie",NA,6,27,33,6,71,77,13,0.26274165202109,0.366193728233863,1139.66948733449,0,0,514
"149","chifightfor15","chifightfor15",NA,2318,27,2345,3286,54,3340,13,0.261388766032729,0.363621854738606,1098586.27505671,0,0,324
"665","FastFoodForward","FastFoodForward",NA,305,27,332,402,69,471,13,0.262084257206208,0.36407306737256,183471.292407038,0,0,324
"769","MontriciaHubba1","MontriciaHubba1",NA,0,27,27,0,41,41,13,0.267144778126401,0.374357689290576,0,0,0,1227
"805","aertwitt","aertwitt",NA,0,27,27,0,38,38,13,0.263181019332162,0.364191178882331,0,0,0,1270
"1210","fightfor15mass","fightfor15mass",NA,358,27,385,445,57,502,13,0.266937669376694,0.374732965849718,311673.909027818,0,0,324
"9442","BoccaJim","BoccaJim",NA,0,27,27,0,49,49,13,0.262389380530973,0.365206041850225,0,0,0,9978
"87","NorCalFF15","NorCalFF15",NA,285,26,311,370,70,440,13,0.261736049601417,0.363057838946164,131796.73719374,0,0,324
"220","Gremlinbroom","Gremlinbroom",NA,0,26,26,0,47,47,13,0.261368653421634,0.363120241245242,0,0,0,609
"1021","still_berning","still_berning",NA,0,26,26,0,34,34,13,0.267344233318604,0.372177161681295,0,0,0,1771
"1307","ColdWarrior2000","ColdWarrior2000",NA,0,26,26,0,43,43,12,0.272768057424854,0.362477393768513,0,0,0,2043
"2089","TheresaSchroe14","TheresaSchroe14",NA,0,26,26,0,37,37,13,0.258397932816537,0.356500860250861,0,0,0,2822
"2276","sardnas51","sardnas51",NA,15,26,41,18,39,57,13,0.260700389105058,0.358513846573549,2330.1372317947,0,0,500
"2979","seiuhcpa","seiuhcpa",NA,32,26,58,40,35,75,13,0.266696750902527,0.373012717682769,55455.3579456192,0,0,324
"7589","Bernlennials","Bernlennials",NA,10,26,36,10,42,52,12,0.280320906087777,0.373622042940226,2782.95524871963,0,0,498
"12522","StellaK22","StellaK22",NA,0,26,26,0,44,44,13,0.260166156536948,0.359720755435042,0,0,0,12946
"1267","gracchus56","gracchus56",NA,0,25,25,0,40,40,13,0.265359477124183,0.365271783498385,0,0,0,1999
"2715","gig_42","gig_42",NA,0,25,25,0,37,37,13,0.266815144766147,0.37084115105818,0,0,0,3435
"3616","ibpixiechick","ibpixiechick",NA,0,25,25,0,27,27,14,0.224271486536333,0.306486459446985,0,0,0,4329
"17352","unravelingjenna","unravelingjenna",NA,1,25,26,1,31,32,12,0.224340175953079,0.282708150600307,610,17,0,17554
"1257","JUNEKIMBARBIE","JUNEKIMBARBIE",NA,0,24,24,0,88,88,13,0.261098901098901,0.36021411248684,0,0,0,1988
"16521","NinosIndex","NinosIndex",NA,0,24,24,0,35,35,12,0.273727647867951,0.363173914304568,0,0,0,16738
"21469","galarole08","galarole08",NA,0,24,24,0,31,31,14,0.224634968176713,0.30567612017612,0,0,0,21519
"52","Show_Me15","Show_Me15",NA,1117,23,1140,2012,48,2060,13,0.260927152317881,0.359137929188691,571843.607501322,0,0,324
"1476","donahuejm","donahuejm",NA,13,23,36,17,29,46,13,0.267786124613345,0.369637815429895,1158.02703624553,0,0,501
"1520","BLACKFLAGchi","BLACKFLAGchi",NA,12,23,35,20,37,57,13,0.260548064375816,0.358320282944658,4337.04122846108,0,0,2262
"1645","MMstrikesback","MMstrikesback",NA,0,23,23,0,41,41,13,0.258503401360544,0.35436723364355,0,0,0,2390
"4155","figue32bj","figue32bj",NA,143,23,166,162,28,190,13,0.259894459102902,0.361317447358057,131663.180531119,0,0,324
"4786","SaveMain_St","SaveMain_St",NA,47,23,70,49,29,78,13,0.247694886839899,0.333785419318415,108007.296532954,0,0,324
"74","irina_florescu","irina_florescu",NA,0,22,22,0,25,25,13,0.261021388040157,0.360396626784587,0,0,0,399
"157","FightFor15FL","FightFor15FL",NA,558,22,580,894,67,961,13,0.255844155844156,0.350883155197877,247196.907973689,0,0,324
"335","FightFor15WI","FightFor15WI",NA,34,22,56,44,66,110,13,0.258530183727034,0.357792348655293,3146.35636513599,0,0,324
"1105","AllynnUmel","AllynnUmel",NA,29,22,51,31,32,63,13,0.262084257206208,0.361309389989594,69568.7501673446,0,0,324
"1205","fredthefrugal","fredthefrugal",NA,0,22,22,0,26,26,13,0.25948539031836,0.356947646191344,0,0,0,1946
"1671","UnionWorkerNY","UnionWorkerNY",NA,0,22,22,0,30,30,13,0.261518209741115,0.361270440968428,0,0,0,2414
"1742","pragmactivist","pragmactivist",NA,173,22,195,192,28,220,12,0.280760095011876,0.372501117044265,82431.261392937,0,0,324
